222222222222222222222222222222222222222222222222222222222222222222222222222222222222222222222
222222222222222222222222222222222222222222222222222222222222222222222222222222222222222222222
222222222222222222222222222222222222222222222222222222222222222222222222222222222222222222222
222222222222222222222222222222222222222222222222222222222200000000000000022222222222222222222
222222222222222222222222222222222222222222222222222222222202222222222222222222222222222222222
222222222222002222222222222222222202220222222222222222222222222222222222222222222222222222222
222222222222022222222222200222222222222002222222222222222222222222222222222222222222222222222
222220222222202222222022220202222222222222222222222222202222222222222222222222222222222222222
222222222220202220000202020222222222222222222222022222222200000000000000000000000000000000000
222222222200202220000002220202222222222222222222222220222222222222222222222222222222222222222
222222222020000000000000000002222222222222222220222222222222222222222222222222222222222222222
222222220200000000000000000002222202222220222222202222222202222222222222222222222222222222222
000000000000000000000000000002222222222222220222222222222222220222222202222222222220222222222
000000000000000000000000000002220222222222220222222202222222222222222222022222222220222222222
000000000000000000000000000002222222222222222222022222222220202022222022222222222000022222202
000000000000000000000000000002222222022222222222222222222222222222222022222222022222222022220
222222222202222222222222222222222222222222222222222222222022222222222222222222222220222222220
000000000000000000000000000000000000000000000000000000000022222222222222222222222202222222220
000000000000000000000000000000000000000000000000000000000022222222222222222222222222222222222

